XXXXXXXXXXXXXXXXX
XOXXOOOXXOOOOOOOO
XOXOOXOXXOXXXXOXX
XOXOXXOOOOOOOOOOX
XOOOSXOXXXXXXXXOX
XXXXXXOOOOOOOOOOX
XXXXXXXXXXXXXXXXX
